//MAP CONVERTED BY dmm2tgm.py THIS HEADER COMMENT PREVENTS RECONVERSION, DO NOT REMOVE
"a" = (
/turf,
/area)
"b" = (
/obj/foo,
/turf,
/area)
"u" = (
/obj/foo{
	a = 4
	},
/turf,
/area)

(1,1,1) = {"
a
a
a
a
a
a
a
a
a
a
"}
(2,1,1) = {"
a
a
a
a
a
a
a
a
a
a
"}
(3,1,1) = {"
a
a
a
a
a
a
a
a
a
a
"}
(4,1,1) = {"
a
a
a
a
a
a
a
a
a
a
"}
(5,1,1) = {"
a
a
a
a
a
a
a
a
a
a
"}
(6,1,1) = {"
a
a
a
a
a
a
a
a
a
a
"}
(7,1,1) = {"
a
a
a
u
a
a
a
a
a
a
"}
(8,1,1) = {"
a
a
b
a
a
a
a
a
a
a
"}
(9,1,1) = {"
a
b
a
a
a
a
a
a
a
a
"}
(10,1,1) = {"
b
a
a
a
a
a
a
a
a
a
"}
